Basic
Level = "Уровень"
Level (Short) = "Ур"
HP = "HP"
HP (Short) = "HP"
MP = "MP"
MP (Short) = "MP"
TP = "SP"
TP (Short) = "SP"

Params
Maximum HP = "MaxHP"
Maximum MP = "MaxMP"
Attack Power = "Атака"
Defense = "Защита"
Magic Power = "Магия"
Magic Defense = "Воля"
Agility = "Ловкость"
Luck = "Сноровка"

ETypes
Weapon = "Правая Рука"
Shield = "Левая Рука"
Head = "Голова"
Body = "Тело"
Ornaments = "Аксессуар"

Commands
Fight = "Бой"
Escape = "Побег"
Attack = "Атака"
Defend = "Защита"
Item = "Вещи"
Skill = "Навыки"
Equipment = "Экипировка"
Status = "Статус"
Sorting = "Порядок"
Save = "Сохранить"
End of Game = "Выйти"
(Missing Number) = ""
Weapons = "Оружие"
Armor = "Броня"
Valuables = "Важные Вещи"
Change Equipment = "Смена Экип."
Best Equipment = "Лучшая Экип."
Remove All = "Снять Все"
New Game = "Новая Игра"
Continue = "Продолжить"
Shutdown = "Выйти"
Go to Title = "В Главное Меню"
Quit = "Отмена"
